*Icons used are from thenounproject
25- Social Media Hand Drawn - https://www.flaticon.com/packs/social-media-hand-drawn
50 - Social Media Hand Drawn - https://www.flaticon.com/packs/social-media-hand-drawn
100 - Social Media Hand Drawn - https://www.flaticon.com/packs/social-media-hand-drawn
abstract-shape - EpicFlatIcon.com
adapter - Stepan Voevodin
approved - Gregor Cresnar
can code - Gan Khoon Lay
climbing-stairs - Universal Icon
composer - Luis Prado
curator - Gan Khoon Lay
curious - To Uyen
decorator - Llisole
factory - Vectors Market
first question - Gregor Cresnar
first-answer - Gregor Cresnar
five-stars - Gregor Cresnar
forum - Dilakuscan
hooked - Scott de Jonge
i know -  yo! baba 
inquisitive - To Uyen
knowledge - Jai
observer - Ewe Jin Tee
programming-genius - Maxim Basinski
programming-junkie - Lakshisha
rated - adnen kadri
reject - Stefania Servidio
right right  - Askhar Pathak
scholar- Vectors Market
social - Konrad Michalik
strategy - B Farias
